11111111
10010C01
10E00001
1100 001
10000001
1000P001
11111111








