11111111
10010C01
10000001
11000001
10000001
1000P001
11111111








