11111111
1001E001
10000001
11000001
10000001
1000P001
11111111








