11111111
1001E001
10000001
11000001
1C000001
10000001
11111111








