11111111111111111111111
1E000000000C00000000001
10100101000010000010101
10100100101000000010101
1P0000000C00000000000C1
11111111111111111111111