11111111111111111111
1E00010C000000000001
10100100100000000101
101000010000B0010101
1P0000C100C000C100C1
11111111111111111111