111111111111111111
1E0000000C00000001
101001000100010101
10100100000B010101
1P00000000000100C1
111111111111111111